18 18 18 18 18 18 18 18 18 18 18 18 18 18 18 18 18 18 18 18 18 18 18 18 18 18 18 18 18 18 18 18 18 18 18 18 18 18 18 18 18 18 18 18 18 18 18 18 18 18 
18 18 18 18 18 18 18 18 18 19 18 18 18 18 18 18 18 18 18 18 18 18 18 18 18 18 18 18 18 18 18 18 18 18 18 18 18 18 18 18 18 18 18 18 18 18 18 18 18 18 
18 18 18 18 18 18 18 18 18 18 18 18 18 18 18 18 18 18 18 18 18 18 18 18 18 18 18 18 18 18 18 18 18 18 18 18 18 18 18 18 18 18 18 18 18 18 18 18 18 18 
18 18 18 19 18 18 18 18 28 26 26 26 26 26 26 26 29 18 18 18 18 18 18 18 18 18 18 19 18 18 18 18 18 18 18 19 18 18 18 18 18 18 18 18 18 18 18 18 18 18 
18 18 18 18 18 18 19 18 24 1 1 1 1 1 1 1 23 19 18 18 18 18 19 18 18 18 18 18 18 18 18 18 18 18 18 18 18 18 18 18 18 18 18 18 18 18 18 18 18 18 
18 18 18 18 18 18 18 18 24 100 1 115 114 1 91 1 23 18 18 18 18 18 18 18 18 18 18 18 18 19 18 19 18 18 18 18 18 18 18 18 18 18 18 18 18 18 18 18 18 18 
18 18 18 18 18 18 18 18 24 40 41 42 43 47 47 48 23 18 28 26 26 26 26 26 26 26 26 29 18 18 18 18 18 18 18 18 18 18 18 18 18 18 18 18 18 18 18 18 18 18 
18 19 18 18 18 18 18 18 24 49 50 51 52 108 50 73 25 26 27 16 1 1 1 1 1 1 1 23 18 18 18 18 18 18 18 18 18 18 18 18 18 18 18 18 18 19 18 18 18 18 
18 18 18 18 18 18 18 18 24 57 36 1 1 1 1 58 16 16 16 16 1 20 21 21 21 22 1 25 26 26 26 26 29 18 131 130 130 130 130 129 128 18 18 18 18 18 18 18 18 18 
18 18 18 18 18 18 18 18 24 57 91 75 76 78 1 57 1 16 16 16 1 23 18 18 18 24 1 16 16 16 16 16 23 18 132 115 114 116 1 1 127 18 18 18 18 18 18 19 18 18 
18 18 18 18 18 18 18 18 24 58 1 79 80 82 1 57 1 16 16 16 1 23 18 18 18 24 1 16 16 16 16 16 23 18 132 113 111 2 1 91 126 18 18 19 18 18 18 18 18 18 
18 18 19 18 18 18 18 18 24 59 60 91 1 1 61 62 1 16 16 16 1 25 26 26 26 27 1 16 16 16 16 16 23 18 132 2 1 2 1 2 126 18 18 18 18 18 18 18 18 18 
18 18 18 18 18 19 18 18 24 74 64 66 1 67 69 70 16 16 16 16 114 1 12 10 13 1 1 1 1 1 1 1 23 18 133 135 121 121 117 120 124 18 18 18 18 18 18 18 18 18 
18 18 18 18 18 18 18 18 24 16 16 16 1 16 16 16 16 16 16 16 16 16 8 3 7 16 16 16 16 16 16 1 25 26 134 136 51 55 118 123 125 29 18 18 18 18 19 18 18 18 
18 18 18 18 18 18 18 18 30 22 16 16 1 16 16 16 16 16 16 16 16 16 8 3 7 16 16 16 16 16 16 1 1 16 16 16 16 1 1 1 1 23 18 18 18 18 18 18 18 18 
18 19 18 18 18 18 18 19 18 24 16 16 1 16 16 16 16 16 16 16 16 16 8 3 7 16 16 16 16 16 16 1 1 1 1 1 1 1 1 1 1 23 18 18 18 18 18 18 18 18 
18 18 18 18 18 18 18 18 28 27 16 16 1 16 16 16 16 16 16 16 16 16 8 3 7 1 1 1 16 16 16 16 16 16 16 16 16 1 1 1 1 23 18 19 18 18 18 18 18 18 
18 18 18 18 18 18 18 28 27 16 16 16 1 16 16 16 16 16 16 16 16 16 8 3 7 16 16 16 16 16 16 16 16 16 16 1 1 1 1 1 1 23 18 18 18 18 18 18 18 18 
18 18 18 18 18 18 18 24 16 16 1 1 1 16 16 16 16 16 16 16 16 16 8 3 7 16 16 16 16 16 16 16 16 16 16 1 1 1 1 1 1 23 18 18 18 18 19 18 18 18 
18 18 18 18 18 19 18 24 16 16 1 16 16 16 16 16 16 16 16 16 16 1 8 3 7 1 16 16 16 16 16 16 16 16 16 1 1 1 1 1 1 23 18 18 18 18 18 18 18 18 
18 18 18 18 18 18 18 24 16 16 1 16 16 1 12 10 10 10 10 10 10 10 11 3 9 10 10 10 10 13 16 16 16 1 1 1 1 1 1 16 1 23 18 19 18 18 18 18 18 18 
18 18 18 19 18 18 18 24 16 16 1 16 16 1 8 3 3 3 3 3 3 3 3 3 3 3 3 3 3 7 1 1 1 1 1 1 1 1 1 20 21 31 18 18 18 18 18 18 18 18 
18 18 18 18 18 18 18 24 16 16 1 16 16 1 14 5 5 5 5 5 5 5 6 3 4 5 5 5 5 15 16 16 16 1 1 1 1 1 2 23 18 18 19 18 18 18 18 18 18 18 
18 18 18 18 18 18 18 30 22 16 1 16 16 1 16 16 16 16 16 16 16 1 8 3 7 1 16 16 16 16 16 16 16 16 16 1 1 1 1 23 18 18 18 18 18 18 18 18 18 18 
18 18 18 18 18 18 18 18 24 16 1 16 16 1 16 16 16 16 16 16 16 16 8 3 7 16 16 16 16 16 16 16 16 16 16 1 1 1 1 23 18 18 18 18 18 18 18 18 18 18 
18 18 18 18 18 18 18 28 27 16 1 16 16 1 1 16 16 16 16 16 16 16 8 3 7 16 16 16 16 16 16 16 16 16 16 1 1 1 1 23 18 18 18 18 18 18 19 18 18 18 
18 18 18 19 18 18 18 24 16 16 1 16 16 16 1 16 16 16 16 16 16 16 8 3 7 16 16 16 16 16 16 16 16 16 16 1 1 1 1 23 18 18 18 18 18 18 18 18 18 18 
18 18 18 18 18 18 18 24 16 16 1 16 16 16 1 16 16 16 16 16 16 16 8 3 7 1 1 1 16 16 16 16 16 16 16 1 1 1 1 23 18 18 18 18 18 18 18 18 18 18 
18 18 18 18 18 18 18 24 16 16 1 16 16 16 1 16 16 16 16 16 16 16 8 3 7 16 16 1 16 16 16 16 16 16 16 1 1 1 1 23 18 18 19 18 18 18 18 18 18 18 
18 18 19 18 18 18 18 24 16 16 1 1 1 1 1 1 16 16 16 16 16 16 8 3 7 16 16 1 16 16 1 16 16 16 16 1 1 1 1 23 18 18 18 18 18 18 18 18 18 18 
18 18 18 18 18 18 18 24 16 16 1 2 1 1 1 1 16 16 16 16 16 16 8 3 7 16 16 1 16 16 1 16 16 16 16 16 1 16 20 31 18 18 18 18 18 18 18 18 18 18 
18 18 18 18 18 18 19 30 22 16 1 1 1 1 2 1 16 16 16 16 16 16 8 3 7 16 16 1 1 1 1 16 16 16 16 16 1 1 23 18 19 18 18 18 18 18 18 18 18 18 
18 18 18 18 18 18 18 18 24 16 91 115 114 2 1 1 16 16 16 16 16 16 8 3 7 16 16 16 16 16 16 16 16 16 16 1 1 1 23 18 18 18 18 18 18 18 18 19 18 18 
18 18 18 18 18 18 18 18 24 16 1 116 112 111 91 1 16 16 16 16 16 16 8 3 7 16 16 16 16 16 16 16 16 16 16 1 1 2 23 18 18 18 18 18 18 18 18 18 18 18 
18 18 18 18 19 18 18 18 24 16 91 2 1 112 2 1 16 16 16 16 16 16 8 3 7 16 16 16 16 16 16 16 16 16 16 1 1 1 23 18 18 18 18 18 18 18 18 18 18 18 
18 18 18 18 18 18 18 28 27 16 16 16 16 16 16 16 16 16 16 16 16 16 14 5 15 16 16 16 16 16 16 16 16 16 16 1 1 1 25 29 18 18 18 18 18 18 18 18 18 18 
18 18 18 18 18 18 18 24 16 16 16 16 16 16 16 16 16 16 16 16 1 1 1 1 1 1 1 16 16 16 16 16 16 16 1 1 1 1 1 25 26 26 26 26 26 26 26 29 18 18 
18 18 18 18 18 18 18 24 16 16 16 16 16 16 16 16 16 16 16 1 61 68 46 60 1 1 1 1 16 16 1 16 16 1 1 2 1 1 1 1 1 1 1 61 110 1 1 23 18 18 
18 18 18 18 18 18 18 24 16 16 16 16 16 16 16 16 16 16 16 67 92 92 93 92 71 66 67 97 42 43 42 41 44 42 42 97 60 1 1 67 68 71 68 69 109 1 1 23 18 18 
18 18 18 18 18 18 18 24 16 16 33 16 16 16 16 16 16 16 16 1 1 1 1 1 1 1 2 49 51 52 64 53 50 51 55 98 92 66 111 2 1 1 113 112 59 42 110 23 18 18 
18 18 18 18 18 19 18 24 16 16 1 16 16 1 1 1 1 1 1 2 2 1 2 1 91 1 1 56 2 2 2 91 2 1 116 106 1 113 112 113 1 116 115 114 74 108 109 23 18 18 
18 18 18 18 18 18 18 24 16 16 1 1 1 1 16 20 21 21 22 1 1 115 113 91 1 2 2 99 2 91 2 2 1 1 1 107 1 1 1 1 1 1 1 1 1 100 58 23 18 18 
18 19 18 18 18 18 18 24 16 16 16 16 16 16 20 31 18 18 30 22 1 113 115 114 2 1 1 104 103 102 71 46 60 1 1 1 1 102 97 71 43 47 46 41 97 42 62 23 18 18 
18 18 18 18 18 18 18 30 21 21 21 21 21 21 31 18 18 18 18 30 21 21 21 21 21 22 2 105 92 96 96 54 92 71 101 1 95 96 98 64 52 51 93 69 98 51 92 23 18 18 
18 18 18 18 18 18 18 18 18 18 18 18 18 18 19 18 18 18 18 18 18 18 18 18 18 24 1 106 91 1 116 1 1 1 1 1 91 1 99 2 1 1 91 1 58 2 1 23 18 18 
18 18 18 18 19 18 18 18 18 18 18 18 18 18 18 18 18 18 18 18 18 18 18 18 18 24 2 107 1 91 1 115 114 111 1 2 1 1 57 1 100 2 2 1 56 1 91 23 18 18 
18 18 18 18 18 18 18 18 18 19 18 18 18 18 18 18 18 18 18 18 18 18 18 19 18 24 1 1 2 1 1 1 112 2 2 111 1 67 62 67 71 68 71 65 62 91 2 23 18 18 
18 18 18 18 18 18 18 18 18 18 18 18 18 18 18 18 18 18 18 18 18 18 18 18 18 30 21 21 21 21 21 21 21 21 21 21 21 21 21 21 21 21 21 21 21 21 21 31 18 18 
18 18 18 18 18 18 18 18 18 18 18 18 18 18 18 18 18 18 18 18 18 18 18 18 18 18 18 18 18 18 18 18 18 18 18 18 18 18 18 18 18 18 18 18 18 18 18 18 18 18 
18 18 18 18 18 18 18 18 18 18 18 18 18 18 18 18 18 18 18 18 18 18 18 18 18 18 18 18 18 18 18 18 18 18 18 18 18 18 18 18 18 18 18 18 18 18 18 18 18 18 
